1111111111111111111111111
100010000000000010P111111
1111E100001111110000C1111
1110000000000000000000011
1111111111111111111111111
1111111111111111111111111