111111111111
1000P0000E11
1100C0000001
1000000C0001
100000000001
1X0000000001
111111111111