111111111111
1000P0000E11
1100C0000001
1000000C0001
100000000001
100N00000011
111111111111